{
    "1":{"board":[
        [1,1,1,1,1,1,1,1,1,1,0,"E"],
            [1,0,0,0,0,1,0,1,1,1,0,1],
            [1,0,1,1,0,1,0,1,1,1,0,1],
            [1,0,1,1,0,1,0,0,1,0,0,1],
            [1,0,0,0,0,1,1,0,0,0,1,1],
            [1,0,1,1,0,0,0,0,1,1,0,1],
            [1,0,1,1,0,1,1,0,1,1,0,1],
            [1,0,1,1,0,0,0,0,0,0,0,1],
            [1,0,0,0,0,1,1,0,0,1,1,1],
            [1,0,1,1,0,1,1,1,1,1,0,1],
            [1,0,1,0,0,0,0,0,0,0,0,0],
            [1,1,0,0,1,1,1,0,0,1,1,0],
            ["S",0,0,1,0,0,0,0,1,0,0,0]],
        "startX":0,
        "startY":12,
        "endX":11,
        "endY":0},
    "2":[
        [0,0,0,0,0,0,0,0,0,0,0,0],
        [0,0,0,0,0,0,0,0,0,0,0,0],
        [0,0,0,0,0,0,0,0,0,0,0,0],
        [0,0,0,0,0,0,0,0,0,0,0,0],
        [0,0,0,0,0,0,0,0,0,0,0,0],
        [0,0,0,0,0,0,0,0,0,0,0,0],
        [0,0,0,0,0,0,0,0,0,0,0,0],
        [0,0,0,0,0,0,0,0,0,0,0,0],
        [0,0,0,0,0,0,0,0,0,0,0,0],
        [0,0,0,0,0,0,0,0,0,0,0,0],
        [0,0,0,0,0,0,0,0,0,0,0,0],
        [0,0,0,0,0,0,0,0,0,0,0,0],
        [0,0,0,0,0,0,0,0,0,0,0,0]
        ],
    "3":[
        [0,0,0,0,0,0,0,0,0,0,0,0],
        [0,0,0,0,0,0,0,0,0,0,0,0],
        [0,0,0,0,0,0,0,0,0,0,0,0],
        [0,0,0,0,0,0,0,0,0,0,0,0],
        [0,0,0,0,0,0,0,0,0,0,0,0],
        [0,0,0,0,0,0,0,0,0,0,0,0],
        [0,0,0,0,0,0,0,0,0,0,0,0],
        [0,0,0,0,0,0,0,0,0,0,0,0],
        [0,0,0,0,0,0,0,0,0,0,0,0],
        [0,0,0,0,0,0,0,0,0,0,0,0],
        [0,0,0,0,0,0,0,0,0,0,0,0],
        [0,0,0,0,0,0,0,0,0,0,0,0],
        [0,0,0,0,0,0,0,0,0,0,0,0]
        ]
        
}